NO ./textures/128x128/Ripple/Vertical_Ripple_1-128x128.png
SO ./textures/128x128/Ripple/Horizontal_Ripple_01-128x128.png
WE ./textures/128x128/Tiled/Vertical_Tile_2-128x128.png
EA ./textures/128x128/Circular/Circular_09-128x128.png
F 2,0,80
C 2,0,1

111111111111111111111111111111111
100000001000000000110000000000001
100000001011000001110000000000001
100000001001000000000000000000001
111111111011000001110000000000001
100000000011000001110111111111111
111101111111110111000000100010001
111101111111110111010100100010001
110000001101010111000000100010001
100000000000000011000000100010001
100000000000000011010100100010001
11000001110101011111011110N011101
111101110111010101011110100010001
111100001111111111111111110011111
111100001111111111111111110011111
111111111                1111
