NO ./textures/N.png     
SO ./textures/S.png   

      F      181,158,65   
   WE            ./textures/W.png 
EA  ./textures/E.png         


C    181  ,         158   ,    65


                   11111111
            111       101
        111110111111111011111111
        1000000000110000000000001
        1011000001110000000000001
        1001000000000000000000001
111111111011000001110000000000001
100000000011000001110111111111111
11110111111111011100000010001
11110111111111011101010010001
11000000110101011100000000001
10000000000000001100000010001
10000000000000001101010010001
11000001110101011111011110N0111
11110111 1110101 101111010001
11110111 1110111 111111111111
   111     111
