11111111111111111111
10000000000100000001
10000000000100000001
10C000000001E0000001
10000000000111111111
10000000000000000001
10000000000000000001
10000000000000000001
100000000C0000000001
10000000000000000001
10000000000000000001
100000000000P0000001
10000000000000000001
11111111111111111111
